NO ./path_to_the_north_texture
SO ./path_to_the_south_texture
WE ./path_to_the_west_texture
EA ./path_to_the_east_texture

F 220,100,0
C 225,30,0

11111111111
10100000001
10100100001
10100010001
10000000001
100000N0001
10000000101
10000000001
11111111111
