NO ./textures/wolf/bluewall.xpm
SO ./textures/wolf/bluewall.xpm
WE ./textures/wolf/darkbluewall.xpm
EA ./textures/wolf/darkbluewall.xpm

F 57,55,57
C 100,98,100

      111
      101
      101   
111111000111111
100001000100001
100000000000001
100001000100001
111111000111111
100001000100001
10E000000000001
100001000100001
111111000111111
100000000000001
100000000000001
100000000000001q